{
  "CN": "zh",
  "TW": "zh",
  "HK": "zh",
  "MO": "zh",
  "JP": "ja",
  "KR": "ko",
  "RU": "ru",
  "FR": "fr",
  "DE": "de",
  "ES": "es",
  "PT": "pt",
  "IT": "it",
  "NL": "nl",
  "SE": "sv",
  "NO": "no",
  "FI": "fi",
  "PL": "pl",
  "CZ": "cs",
  "SK": "sk",
  "HU": "hu",
  "RO": "ro",
  "BG": "bg",
  "GR": "el",
  "TR": "tr",
  "UA": "uk",
  "BY": "be",
  "AR": "es",
  "BR": "pt",
  "MX": "es",
  "CO": "es",
  "CL": "es",
  "PE": "es",
  "US": "en",
  "GB": "en",
  "CA": "en",
  "AU": "en",
  "NZ": "en",
  "IE": "en",
  "IN": "hi",
  "PK": "ur",
  "BD": "bn",
  "LK": "si",
  "TH": "th",
  "VN": "vi",
  "MY": "ms",
  "ID": "id",
  "PH": "fil",
  "SA": "ar",
  "AE": "ar",
  "EG": "ar",
  "IL": "he",
  "IR": "fa",
  "AF": "fa",
  "ZA": "en",
  "NG": "en",
  "KE": "sw",
  "TZ": "sw",
  "ET": "am",
  "IS": "is",
  "DK": "da",
  "BE": "nl",
  "CH": "de",
  "AT": "de",
  "PT": "pt",
  "SE": "sv",
  "NO": "no",
  "FI": "fi"
}
